C 17,  17,  	17
F   43, 052, 62

EA ./assets/textures/wall/M1.xpm

NO ./assets/textures/wall/M3.xpm

SO ./assets/textures/wall/M5.xpm

WE ./assets/textures/wall/M2.xpm
111111111111111111111111
10000000N000000000110001
10000000000000000110001
100000000000000000110001
100000000000000000110001
111111110111101111110001
111111100011100000000001
111111100011111111111111
100000000000000000110001
100000000000000000110001
100000000000000000110001
100000000000000000110001
111111100011101111110001
111111100011100000000001
111111100011111111111111
100000000000000000110001
100000000000000000110001
100000000000000000110001
100000000000000000110001
111111100011101111110001
111111100011100000000001
111111100011111111111111
100000000000000000110001
100000000000000000110001
100000000000000000110001
100000000000000000110001
1111111000111011110000011
11111100011100000000000001
1111111111111111111111111
