C		  10, 			231 ,227 						
F	123,55,87	

   EA             ./assets/textures/wall_1.xpm  
NO          ./assets/textures/wall_2.xpm  
       SO             ./assets/textures/wall_3.xpm                    
WE            ./assets/textures/wall_4.xpm       

11111111111111111
10000000000000001
10100000100000101
10000000000000001
10001000100010001
10000000000000001
10101010S01010101
10000000000000001
10001000100100001
10000000000000001
10100000100001001
00000000000000001
11111111111111111




