C		  10, 			231 ,227 						
F	123,55,87	

EA	./assets/textures/wall/east.xpm  
NO	./assets/textures/wall/north.xpm  
SO	./assets/textures/wall/south.xpm                 
WE	./assets/textures/wall/west.xpm   

11111111111111111
10000000000010001
10000000000000001
10000000000000001
10000000000000001
10000000000000001
10000000N00000001
10000000000000001
10000000000000001
10000000000000001
10000000000000001
10000000000000001
11111111111111111
