C		  42, 			231,227
F	123,55,42
EA ./assets/textures/wall_1.xpm
NO ./assets/textures/wall_2.xpm
SO ./assets/textures/wall_3.xpm 
WE ./assets/textures/wall_4.xpm 


11111111111
10000010001
10000010001
1C11O110001
10000000001
10000000001
1N000000001
10000000001
11111111111
